Z:  
Т: с
G: о
у: и
3: е
F: а
i: з
U: п
R: д
Д: н
Я: к
9: ц
7: л
1: я
Х: т
Y: р
%: б
Ё: ч
=: ы
г: в
N: м
ю: ж
И: у
К: щ
J: х
s: ь
Р: ю
Й: г
<: э
Ж: й
@: ф
